,,,,,,,,,,,,,,,,,,,,,,,,,,,,,,,,
,..............................,
,..............................,
,..............................,
,..............................,
,..............................,
,..............................,
,..............................,
,..............................,
,..............................,
,..............................,
,..............................,
,..............................,
,..............................,
,..............................,
,..............................,
,..............................,
,..............................,
,..............................,
,..............................,
,..............................,
,..............................,
,..............P...............,
,,,,,,,,,,,,,,,,,,,,,,,,,,,,,,,,