,,,,,,,,,,,,,,,,,,,,,,,,,,,,,,,,
,..............................,
,..............................,
,..............................,
,..............................,
,..............................,
,..............................,
,..............................,
,..............................,
,..............................,
,..............................,
,..............................,
,..............................,
,..............................,
,..............................,
,..............................,
,..............................,
,..............................,
,..............................,
,..............................,
,..............................,
,..............P...............,
,..............................,
,,,,,,,,,,,,,,,,,,,,,,,,,,,,,,,,